9999999999999999999999999999
9999999999999999999999999999
9999999999999999999999999999
9999999999999999999999999999
9999999999999999999999999999
9999999999999999999999999999
9999999999999999999999999999
9999999999999999999999999999
9999999999999999999999999999
9999999999999999999999999999
9999999999999999999999999999
9999999999999999999999999999
99999991HHHH0HH1HHH099999999
9999999V4444VNIV444V99999999
9999999V444428834B4V99999999
9999999V99999999999V99999999
9999999V99999999999V99999999
9999999V99999999999V99999999
9999999V79999P9999FV99999999
99999992HHHHHHHHHHH399999999
9999999999999999999999999999
9999999999999999999999999999
9999999999999999999999999999
9999999999999999999999999999
9999999999999999999999999999
9999999999999999999999999999
9999999999999999999999999999
9999999999999999999999999999
9999999999999999999999999999
9999999999999999999999999999
9999999999999999999999999999