9999999999999999999999999999
9999999999999999999999999999
991HHHHHHH091HHHHHHH09999999
99V7444444V9V4444447V9999999
99V4999994V9V4999994V9999999
99V4918094V9V4919094V9999999
99V49VNV94V9V49VBV94V9999999
99V492H394V9V492H394V9999999
99V49999942H34999994V9999999
99V44444444444444444V9999999
992HHHHH0499941HHHHH39999999
99999999V49F94V9999999999999
991HHHHH349P942HHHHH09999999
99V44444444444444444V9999999
99V49999941H04999994V9999999
99V4918094V9V4918094V9999999
99V49VCV94V9V49VIV94V9999999
99V492H394V9V492H394V9999999
99V4999994V9V4999994V9999999
99V7444444V9V4444447V9999999
992HHHHHHH392HHHHHHH39999999
9999999999999999999999999999
9999999999999999999999999999
9999999999999999999999999999
9999999999999999999999999999
9999999999999999999999999999
9999999999999999999999999999
9999999999999999999999999999
9999999999999999999999999999
9999999999999999999999999999
9999999999999999999999999999