1HHHHHHHHHHHH01HHHHHHHHHHHH0
V444444444444VV444444444444V
V41HH041HHH04VV41HHH041HH04V
V7V99V4V999V4VV4V999V4V99V7V
V42HH342HHH342342HHH342HH34V
V44444444444444444444444444V
V41HH041041HHHHHH041041HH04V
V42HH34VV42HH01HH34VV42HH34V
V444444VV4444VV4444VV444444V
2HHHH04V2HH09VV91HH3V41HHHH3
99999V4V1HH392392HH0V4V99999
99999V4VV9999B99999VV4V99999
99999V4VV91HH88HH09VV4V99999
HHHHH34239V999999V92342HHHHH
9999994999VI9N9C9V9994999999
HHHHH04109V999999V91041HHHHH
99999V4VV92HHHHHH39VV4V99999
99999V4VV9999F99999VV4V99999
99999V4VV91HHHHHH09VV4V99999
1HHHH342392HH01HH392342HHHH0
V444444444444VV444444444444V
V41HH041HHH04VV41HHH041HH04V
V42H0V42HHH342342HHH34V1H34V
V744VV4444444P44444444VV447V
2H04VV41041HHHHHH04104VV41H3
1H34234VV42HH01HH34VV42342H0
V444444VV4444VV4444VV444444V
V41HHHH32HH04VV41HH32HHHH04V
V42HHHHHHHH342342HHHHHHHH34V
V44444444444444444444444444V
2HHHHHHHHHHHHHHHHHHHHHHHHHH3