4111111111111341111111111113
2000000000000220000000000002
2041130411130220411130411302
2729920299920220299920299272
2051160511160560511160511602
2000000000000000000000000002
2041130430411111130430411302
2051160220511341160220511602
2000000220000220000220000002
5111130251139229411620411116
9999920241169569511320299999
9999920229999999999220299999
9999920229411881139220299999
1111160569299999929560511111
9999990999299999929990999999
1111130439299999929430411111
9999920229511111169220299999
9999920229999C99999220299999
9999920229411111139220299999
4111160569511341169560511113
2000000000000220000000000002
2041130411130220411130411302
2051320511160560511160241602
2700220000000P00000000220072
5130220430411111130430220416
4160560220511341160220560513
2000000220000220000220000002
2041111651130220411651111302
2051111111160560511111111602
2000000000000000000000000002
5111111111111111111111111116