1111111111111111111111111111
1000000000000110000000000001
1011110111110110111110111101
1211110111110110111110111121
1011110111110110111110111101
1000000000000000000000000001
1011110110111111110110111101
1011110110111111110110111101
1000000110000110000110000001
1111110111114114111110111111
4444410111114114111110144444
4444410114444444444110144444
4444410114111331114110144444
1111110114144444414110111111
4444440444144444414440444444
1111110114144444414110111111
4444410114111111114110144444
4444410114444444444110144444
4444410114111111114110144444
1111110114111111114110111111
1000000000000110000000000001
1011110111110110111110111101
1011110111110110111110111101
1200110000000000000000110021
1110110110111111110110110111
1110110110111111110110110111
1000000110000110000110000001
1011111111110110111111111101
1011111111110110111111111101
1000000000000000000000000001
1111111111111111111111111111