9999999999999999999999999999
991HHHHHHHHHHHHHHHHHHHH09999
99V44444444444444444444V9999
99V44444444444444444444V9999
99V44444444444444444444V9999
99V4444444441HH04444444V9999
99V444444444VCIV9999999V9999
99V444444444V99V9999999V9999
99V99999999928839999999V9999
99V99999999999999999999V9999
99V99999999999999999999V9999
99V99999999999999999999V9999
99V99999999999999999999V9999
992HHHHHHHHH09999999999V9999
991HHHHHHHHH39999999999V9999
99V99999999999999999999V9999
99V9999999999P999999999V9999
99V99999999999999999999V9999
99V99999999999999999999V9999
99V91HHHHHHHHHHH091HHHH39999
99V92HHHHHHHHHHH3F2HHHH09999
99V99999999999999999999V9999
99V99999999944999999999V9999
99V99999944499949999999V9999
99V99999944449444999999V9999
99V99994949999999499999V9999
99V99999994999994444999V9999
99V99999944999999944999V9999
99V99999999999999449999V9999
992HHHHHHHHHHHHHHHHHHHH39999
9999999999999999999999999999
